#   #  G#
# ###   #
#  ## ###
# ### ###
#       #
### #####
S    ####